ACCC_sample_ID	C>A	C>G	C>T	T>A	T>C	T>G	C>T at CpG	C>T other
CRC_ACCC_01	30	9	107	3	16	9	77	30
CRC_ACCC_03	16	3	92	5	10	6	71	21
CRC_ACCC_04	59	42	132	25	33	28	85	47
CRC_ACCC_05	220	39	3116	76	378	43	2560	556
CRC_ACCC_06	589	166	3504	181	510	72	1717	1787
CRC_ACCC_07	30	19	104	20	10	5	83	21
CRC_ACCC_08	2	0	2	0	1	5	1	1
CRC_ACCC_09	195	30	1095	31	233	43	772	323
CRC_ACCC_11	27	20	131	9	13	14	92	39
CRC_ACCC_12	19	11	74	7	17	4	49	25
CRC_ACCC_13	14	4	83	1	11	8	67	16
CRC_ACCC_14	2	1	37	0	5	2	30	7
CRC_ACCC_15	5167	72	11481	170	3189	1862	7187	4294
CRC_ACCC_16	24	7	132	5	12	9	101	31
CRC_ACCC_17	131	18	879	24	147	31	647	232
CRC_ACCC_18	35	22	114	7	13	9	83	31
CRC_ACCC_19	22	8	133	2	11	6	103	30
CRC_ACCC_20	30	28	147	15	27	16	101	46
CRC_ACCC_21	134	14	1317	41	225	31	1011	306
CRC_ACCC_22	9	5	28	2	10	3	13	15
CRC_ACCC_23	28	9	217	6	23	8	176	41
CRC_ACCC_24	229	21	1039	54	947	77	672	367
CRC_ACCC_25	26	6	89	7	16	5	70	19
CRC_ACCC_26	2	0	5	1	7	0	3	2
CRC_ACCC_27	12	7	83	3	12	7	61	22
CRC_ACCC_28	45	22	137	13	29	13	109	28
CRC_ACCC_29	3	1	8	3	2	2	5	3
